State,PC Name,Male Electors,Male Voters,Male Turnout,Female Electors,Female Voters,Female Turnout,Total Electors,Total Voters,Total Turnout
Andaman & Nicobar Islands,1 - Andaman & Nicobar Islands,142782,101178,70.86 %,126578,89150,70.43 %,269360,190328,70.66 %
,State Total: ,142782,101178,70.86 %,126578,89150,70.43 %,269360,190328,70.66 %
Andhra Pradesh,1 - Adilabad ,687389,519364,75.56 %,698844,526475,75.34 %,1386233,1045839,75.44 %
,2 - Peddapalle ,725767,520598,71.73 %,699594,501586,71.70 %,1425361,1022184,71.71 %
,3 - Karimnagar ,777458,552489,71.06 %,773376,573202,74.12 %,1550834,1125691,72.59 %
,4 - Nizamabad,724504,469712,64.83 %,771689,564212,73.11 %,1496193,1033924,69.10 %
,5 - Zahirabad,717811,546746,76.17 %,727435,548060,75.34 %,1445246,1094806,75.75 %
,6 - Medak,775903,606863,78.21 %,760812,584233,76.79 %,1536715,1191096,77.51 %
,7 - Malkajgiri,1723413,878093,50.95 %,1459912,742304,50.85 %,3183325,1620397,50.90 %
,8 - Secundrabad,1012378,545749,53.91 %,881269,458020,51.97 %,1893647,1003769,53.01 %
,9 - Hyderabad,961290,526510,54.77 %,862374,444911,51.59 %,1823664,971421,53.27 %
,10 - CHELVELLA,1153049,696749,60.43 %,1032130,619113,59.98 %,2185179,1315862,60.22 %
,11 - Mahbubnagar,709711,511764,72.11 %,708961,503036,70.95 %,1418672,1014800,71.53 %
,12 - Nagarkurnool,745038,570342,76.55 %,732300,538626,73.55 %,1477338,1108968,75.07 %
,13 - Nalgonda,747281,602193,80.58 %,748299,587206,78.47 %,1495580,1189399,79.53 %
,14 - Bhongir ,756963,622333,82.21 %,735288,589610,80.19 %,1492251,1211943,81.22 %
,15 - Warangal,771756,592484,76.77 %,766025,582147,76.00 %,1537781,1174631,76.38 %
,16 - Mahabubabad  ,688398,562073,81.65 %,698945,562297,80.45 %,1387343,1124370,81.04 %
,17 - Khammam ,712329,588728,82.65 %,727960,594169,81.62 %,1440289,1182897,82.13 %
,18 - Aruku ,622416,451350,72.52 %,650308,458264,70.47 %,1272724,909614,71.47 %
,19 - Srikakulam,706828,505010,71.45 %,707161,546436,77.27 %,1413989,1051446,74.36 %
,20 - Vizianagaram,700837,555005,79.19 %,703290,565311,80.38 %,1404127,1120316,79.79 %
,21 - Visakhapatnam,875187,585270,66.87 %,847850,578288,68.21 %,1723037,1163558,67.53 %
,22 - Anakapalli,689132,563818,81.82 %,712342,584254,82.02 %,1401474,1148072,81.92 %
,23 - Kakinada,709101,558689,78.79 %,709189,541310,76.33 %,1418290,1099999,77.56 %
,24 - Amalapuram ,682607,568534,83.29 %,675259,552393,81.80 %,1357866,1120927,82.55 %
,25 - Rajahmundry,701707,577999,82.37 %,719581,576382,80.10 %,1421288,1154381,81.22 %
,26 - Narsapuram,652668,539357,82.64 %,672475,549594,81.73 %,1325143,1088951,82.18 %
,27 - Eluru ,706916,597603,84.54 %,720844,604093,83.80 %,1427760,1201696,84.17 %
,28 - Machilipatnam ,675774,567908,84.04 %,693537,573157,82.64 %,1369311,1141065,83.33 %
,29 - Vijayawada,781156,602198,77.09 %,783357,592877,75.68 %,1564513,1195075,76.39 %
,30 - Guntur,773027,617483,79.88 %,798989,627443,78.53 %,1572016,1244926,79.19 %
,31 - Narasaraopet,748465,638080,85.25 %,766396,643978,84.03 %,1514861,1282058,84.63 %
,32 - Bapatla ,686482,587223,85.54 %,706483,597411,84.56 %,1392965,1184634,85.04 %
,33 - Ongole ,736245,603025,81.91 %,734238,605200,82.43 %,1470483,1208225,82.17 %
,34 - Nandyal,783266,603562,77.06 %,793862,601394,75.76 %,1577128,1204956,76.40 %
,35 - Kurnool,738791,544802,73.74 %,743016,520930,70.11 %,1481807,1065732,71.92 %
,36 - Anantapur,775509,612890,79.03 %,761403,592164,77.77 %,1536912,1205054,78.41 %
,37 - Hindupur,734638,601932,81.94 %,711865,575325,80.82 %,1446503,1177257,81.39 %
,38 - Kadapa,765036,588805,76.96 %,785543,611857,77.89 %,1550579,1200662,77.43 %
,39 - Nellore,796583,593468,74.50 %,809557,594180,73.40 %,1606140,1187648,73.94 %
,40 - Tirupati ,778778,604834,77.66 %,795766,608230,76.43 %,1574544,1213064,77.04 %
,41 - Rajampet,735347,573019,77.92 %,752151,585298,77.82 %,1487498,1158317,77.87 %
,42 - Chittoor ,723996,598259,82.63 %,728145,600656,82.49 %,1452141,1198915,82.56 %
,State Total: ,32670930,24352913,74.54 %,32267820,24005632,74.39 %,64938750,48358545,74.47 %
Arunachal Pradesh,1 - ARUNACHAL WEST,219334,159978,72.94 %,227181,175687,77.33 %,446515,335665,75.17 %
,2 - ARUNACHAL EAST,160293,129313,80.67 %,152579,131978,86.50 %,312872,261291,83.51 %
,State Total: ,379627,289291,76.2 %,379760,307665,81.02 %,759387,596956,78.61 %
Assam,1 - Karimganj ,615198,482484,78.43 %,550799,404436,73.43 %,1165997,886920,76.07 %
,2 - Silchar,554540,428949,77.35 %,505635,370881,73.35 %,1060175,799830,75.44 %
,3 - Autonomous District,358880,279409,77.86 %,343010,263871,76.93 %,701890,543280,77.40 %
,4 - Dhubri,798124,709191,88.86 %,754430,660433,87.54 %,1552554,1369624,88.22 %
,5 - Kokrajhar,776071,636657,82.04 %,729405,587212,80.51 %,1505476,1223869,81.29 %
,6 - Barpeta,755559,634405,83.96 %,674616,571458,84.71 %,1430175,1205863,84.32 %
,7 - Gauhati,988067,785494,79.50 %,934203,726235,77.74 %,1922270,1511729,78.64 %
,8 - Mangaldoi,791539,651272,82.28 %,724137,581965,80.37 %,1515676,1233237,81.37 %
,9 - Tezpur,654866,505643,77.21 %,604702,475045,78.56 %,1259568,980688,77.86 %
,10 - Nowgong,792424,639392,80.69 %,731457,590682,80.75 %,1523881,1230074,80.72 %
,11 - Kaliabor,752785,605292,80.41 %,705080,561198,79.59 %,1457865,1166490,80.01 %
,12 - Jorhat,634236,483829,76.29 %,600212,447507,74.56 %,1234448,931336,75.45 %
,13 - Dibrugarh,579657,462412,79.77 %,544648,428556,78.68 %,1124305,890968,79.25 %
,14 - Lakhimpur,735263,572334,77.84 %,695731,539641,77.56 %,1430994,1111975,77.71 %
,State Total: ,9787209,7876763,80.48 %,9098065,7209120,79.24 %,18885274,15085883,79.88 %
Bihar,1 - Valmiki Nagar,786297,484621,61.63 %,670279,415493,61.99 %,1456576,900114,61.80 %
,2 - Paschim Champaran,769352,469114,60.98 %,643721,385686,59.92 %,1413073,854800,60.49 %
,3 - Purvi Champaran,788561,442103,56.06 %,664402,380568,57.28 %,1452963,822671,56.62 %
,4 - Sheohar,794679,433416,54.54 %,695045,409478,58.91 %,1489724,842894,56.58 %
,5 - Sitamarhi,832370,449303,53.98 %,742544,451285,60.78 %,1574914,900588,57.18 %
,6 - Madhubani,877284,413878,47.18 %,750685,446575,59.49 %,1627969,860453,52.85 %
,7 - Jhanjharpur,884884,452082,51.09 %,765869,489167,63.87 %,1650753,941249,57.02 %
,8 - Supaul,796979,468183,58.74 %,728613,502345,68.95 %,1525592,970528,63.62 %
,9 - Araria,842884,492492,58.43 %,744464,483319,64.92 %,1587348,975811,61.47 %
,10 - Kishanganj,762877,471209,61.77 %,676113,457281,67.63 %,1438990,928490,64.52 %
,11 - Katihar,769044,495564,64.44 %,677434,482266,71.19 %,1446478,977830,67.60 %
,12 - Purnia,833610,511512,61.36 %,749357,506220,67.55 %,1582967,1017732,64.29 %
,13 - Madhepura,899271,508914,56.59 %,826307,525885,63.64 %,1725578,1034799,59.97 %
,14 - Darbhanga,797470,407047,51.04 %,697976,421295,60.36 %,1495446,828342,55.39 %
,15 - Muzaffarpur,830943,490954,59.08 %,720420,457933,63.56 %,1551363,948887,61.16 %
,16 - Vaishali,854781,482598,56.46 %,732421,443339,60.53 %,1587202,925937,58.34 %
,17 - Gopalganj (SC),861019,446731,51.88 %,791748,456852,57.70 %,1652767,903583,54.67 %
,18 - Siwan,841735,443867,52.73 %,722125,440154,60.95 %,1563860,884021,56.53 %
,19 - Maharajganj,882264,420364,47.65 %,762260,426290,55.92 %,1644524,846654,51.48 %
,20 - Saran,833361,450964,54.11 %,705383,412290,58.45 %,1538744,863254,56.10 %
,21 - Hajipur (SC),895047,478252,53.43 %,754500,426501,56.53 %,1649547,904753,54.85 %
,22 - Ujiarpur,768123,433926,56.49 %,660322,424994,64.36 %,1428445,858920,60.13 %
,23 - Samastipur (SC),805601,430736,53.47 %,697404,432463,62.01 %,1503005,863199,57.43 %
,24 - Begusarai,949825,546041,57.49 %,828934,531814,64.16 %,1778759,1077855,60.60 %
,25 - Khagaria,793168,445965,56.23 %,698900,450266,64.42 %,1492068,896231,60.07 %
,26 - Bhagalpur,895185,522657,58.39 %,790154,451359,57.12 %,1685339,974016,57.79 %
,27 - Banka,825010,461098,55.89 %,724446,438255,60.50 %,1549456,899353,58.04 %
,28 - Munger,921436,506184,54.93 %,775110,408166,52.66 %,1696546,914350,53.89 %
,29 - Nalanda,1036575,503097,48.53 %,915392,418664,45.74 %,1951967,921761,47.22 %
,30 - Patna Sahib,1052278,511447,48.60 %,893971,370815,41.48 %,1946249,882262,45.33 %
,31 - Pataliputra,934086,553915,59.30 %,801988,424734,52.96 %,1736074,978649,56.37 %
,32 - Arrah,1010040,516366,51.12 %,822292,376847,45.83 %,1832332,893213,48.75 %
,33 - Buxar,878312,493930,56.24 %,762255,394274,51.72 %,1640567,888204,54.14 %
,34 - Sasaram (SC),859397,474117,55.17 %,748350,372671,49.80 %,1607747,846788,52.67 %
,35 - Karakat,845707,453576,53.63 %,724282,336351,46.44 %,1569989,789927,50.31 %
,36 - Jahanabad,751585,443737,59.04 %,671661,367779,54.76 %,1423246,811516,57.02 %
,37 - Aurangabad,825574,430800,52.18 %,710579,355474,50.03 %,1536153,786274,51.18 %
,38 - Gaya (SC),790868,444510,56.21 %,709883,364868,51.40 %,1500751,809378,53.93 %
,39 - Nawada,887050,478217,53.91 %,788739,406224,51.50 %,1675789,884441,52.78 %
,40 - Jamui (SC),828406,415743,50.19 %,722530,359896,49.81 %,1550936,775639,50.01 %
,State Total: ,34092938,18779230,55.08 %,29668858,17106136,57.66 %,63761796,35885366,56.28 %
Chandigarh,1 - CHANDIGARH,333621,244956,73.42 %,281593,208499,74.04 %,615214,453455,73.71 %
,State Total: ,333621,244956,73.42 %,281593,208499,74.04 %,615214,453455,73.71 %
Chattisgarh,1 - SARGUJA,771303,610877,79.20 %,751769,576444,76.68 %,1523072,1187321,77.96 %
,2 - RAIGARH,807353,630570,78.10 %,798471,615616,77.10 %,1605824,1246186,77.60 %
,3 - JANJGIR-CHAMPA,890439,558677,62.74 %,847093,514670,60.76 %,1737532,1073347,61.77 %
,4 - KORBA,725821,546046,75.23 %,693789,506674,73.03 %,1419610,1052720,74.16 %
,5 - BILASPUR,889222,573253,64.47 %,838103,517204,61.71 %,1727325,1090457,63.13 %
,6 - RAJNANDGAON,794427,601874,75.76 %,793668,576422,72.63 %,1588095,1178296,74.20 %
,7 - DURG,945656,660504,69.85 %,910125,597838,65.69 %,1855781,1258342,67.81 %
,8 - RAIPUR,979133,659070,67.31 %,925097,591775,63.97 %,1904230,1250845,65.69 %
,9 - MAHASAMUND,757276,576917,76.18 %,758471,554292,73.08 %,1515747,1131209,74.63 %
,10 - BASTAR,632814,387112,61.17 %,665245,382801,57.54 %,1298059,769913,59.31 %
,11 - KANKER,722339,515793,71.41 %,725435,501150,69.08 %,1447774,1016943,70.24 %
,State Total: ,8915783,6320693,70.89 %,8707266,5934886,68.16 %,17623049,12255579,69.54 %
Dadra & Nagar Haveli,1 - Dadar & Nagar Haveli,106215,87800,82.66 %,90402,77486,85.71 %,196617,165286,84.06 %
,State Total: ,106215,87800,82.66 %,90402,77486,85.71 %,196617,165286,84.06 %
Daman & Diu,1 - Daman & diu,57011,42378,74.33 %,54816,44855,81.83 %,111827,87233,78.01 %
,State Total: ,57011,42378,74.33 %,54816,44855,81.83 %,111827,87233,78.01 %
Goa,1 - North Goa,255870,200184,78.24 %,259571,206447,79.53 %,515441,406631,78.89 %
,2 - South Goa,272438,195582,71.79 %,272898,214787,78.71 %,545336,410369,75.25 %
,State Total: ,528308,395766,74.91 %,532469,421234,79.11 %,1060777,817000,77.02 %
Gujarat,1 - Kachchh,806343,520905,64.60 %,727439,425335,58.47 %,1533782,946240,61.69 %
,2 - Banaskantha,796124,513893,64.55 %,719587,372741,51.80 %,1515711,886634,58.50 %
,3 - Patan,846195,529513,62.58 %,782446,426286,54.48 %,1628641,955799,58.69 %
,4 - Mahesana,777821,544710,70.03 %,720398,459548,63.79 %,1498219,1004258,67.03 %
,5 - Sabarkantha,833521,587807,70.52 %,782319,506195,64.70 %,1615840,1094002,67.70 %
,6 - Gandhinagar,900744,620889,68.93 %,833228,514606,61.76 %,1733972,1135495,65.49 %
,7 - Ahmedabad East,852765,560074,65.68 %,749067,425451,56.80 %,1601832,985525,61.52 %
,8 - Ahmedabad West,800933,534008,66.67 %,733467,430601,58.71 %,1534400,964609,62.87 %
,9 - Surendranagar,877745,542339,61.79 %,778912,402338,51.65 %,1656657,944677,57.02 %
,10 - Rajkot,864760,593333,68.61 %,790957,463736,58.63 %,1655717,1057069,63.84 %
,11 - Porbandar,807383,471495,58.40 %,731840,337938,46.18 %,1539223,809433,52.59 %
,12 - Jamnagar,771004,486177,63.06 %,699948,366466,52.36 %,1470952,852643,57.97 %
,13 - Junagadh,772017,516158,66.86 %,713526,425220,59.59 %,1485543,941378,63.37 %
,14 - Amreli,777662,457547,58.84 %,708624,351269,49.57 %,1486286,808816,54.42 %
,15 - Bhavnagar,834571,519525,62.25 %,759960,397877,52.35 %,1594531,917402,57.53 %
,16 - Anand,781120,541176,69.28 %,715739,429718,60.04 %,1496859,970894,64.86 %
,17 - Kheda,833232,542955,65.16 %,766244,412951,53.89 %,1599476,955906,59.76 %
,18 - Panchmahal,820230,516017,62.91 %,756437,417444,55.19 %,1576667,933461,59.20 %
,19 - Dahod,712184,469459,65.92 %,699581,430922,61.60 %,1411765,900381,63.78 %
,20 - Vadodara,849077,625045,73.61 %,789244,536532,67.98 %,1638321,1161577,70.90 %
,21 - Chhota Udaipur,798160,593192,74.32 %,738145,507350,68.73 %,1536305,1100542,71.64 %
,22 - Bharuch,734861,564668,76.84 %,682687,495543,72.59 %,1417548,1060211,74.79 %
,23 - Bardoli,829648,637345,76.82 %,784458,568834,72.51 %,1614106,1206179,74.73 %
,24 - Surat,803829,539368,67.10 %,680239,408554,60.06 %,1484068,947922,63.87 %
,25 - Navsari,972090,649206,66.78 %,792532,511541,64.55 %,1764622,1160747,65.78 %
,26 - Valsad,775073,582311,75.13 %,736988,539892,73.26 %,1512061,1122203,74.22 %
,State Total: ,21229092,14259115,67.17 %,19374012,11564888,59.69 %,40603104,25824003,63.6 %
Haryana,1 - Ambala,909708,667400,73.36 %,782519,551595,70.49 %,1692227,1218995,72.03 %
,2 - Kurukshetra,807700,618607,76.59 %,690759,517285,74.89 %,1498459,1135892,75.80 %
,3 - Sirsa,886303,692891,78.18 %,774254,586214,75.71 %,1660557,1279105,77.03 %
,4 - Hisar,825688,637718,77.23 %,691918,518196,74.89 %,1517606,1155914,76.17 %
,5 - Karnal,913321,666808,73.01 %,771000,526692,68.31 %,1684321,1193500,70.86 %
,6 - Sonipat,777824,551168,70.86 %,639364,434469,67.95 %,1417188,985637,69.55 %
,7 - Rohtak,850125,578351,68.03 %,717379,465980,64.96 %,1567504,1044331,66.62 %
,8 - Bhiwani-Mahendragarh,792166,559833,70.67 %,681746,470598,69.03 %,1473912,1030431,69.91 %
,9 - Gurgaon,984370,727397,73.89 %,861253,593222,68.88 %,1845623,1320619,71.55 %
,10 - Faridabad,969407,651411,67.20 %,770945,479315,62.17 %,1740352,1130726,64.97 %
,State Total: ,8716612,6351584,72.87 %,7381137,5143566,69.69 %,16097749,11495150,71.41 %
Himachal Pradesh,1 - Kangra,645888,392927,60.84 %,612713,406518,66.35 %,1258601,799445,63.52 %
,2 - Mandi,587833,377569,64.23 %,562575,348525,61.95 %,1150408,726094,63.12 %
,3 - Hamirpur,633572,395804,62.47 %,614127,439401,71.55 %,1247699,835205,66.94 %
,4 - Shimla,607137,403332,66.43 %,546226,334425,61.22 %,1153363,737757,63.97 %
,State Total: ,2474430,1569632,63.43 %,2335641,1528869,65.46 %,4810071,3098501,64.42 %
Jammu & Kashmir,1 - Baramulla,624008,256249,41.07 %,566737,209743,37.01 %,1190745,465992,39.13 %
,2 - Srinagar,630716,178554,28.31 %,574517,133658,23.26 %,1205233,312212,25.90 %
,3 - Anantnag,684820,211582,30.90 %,616203,163697,26.57 %,1301023,375279,28.84 %
,4 - Ladakh,86259,58035,67.28 %,80504,59994,74.52 %,166763,118029,70.78 %
,5 - Udhampur,798910,557757,69.81 %,691334,484001,70.01 %,1490244,1041758,69.91 %
,6 - Jammu,977308,665407,68.09 %,870847,588186,67.54 %,1848155,1253593,67.83 %
,State Total: ,3802021,1927584,50.7 %,3400142,1639279,48.21 %,7202163,3566863,49.52 %
Jharkhand,1 - Rajmahal,691254,491007,71.03 %,661918,460556,69.58 %,1353172,951563,70.32 %
,2 - Dumka,646885,466521,72.12 %,600270,436539,72.72 %,1247155,903060,72.41 %
,3 - Godda,825706,550327,66.65 %,764922,499115,65.25 %,1590628,1049442,65.98 %
,4 - Chatra,696514,383079,55.00 %,616031,329892,53.55 %,1312545,712971,54.32 %
,5 - Kodarma,870016,535513,61.55 %,769613,489393,63.59 %,1639629,1024906,62.51 %
,6 - Giridih,811986,531267,65.43 %,703151,438730,62.39 %,1515137,969997,64.02 %
,7 - Dhanbad,1032005,642644,62.27 %,857989,501258,58.42 %,1889994,1143902,60.52 %
,8 - Ranchi,868783,562894,64.79 %,779681,486889,62.45 %,1648464,1049783,63.68 %
,9 - Jamshedpur,811632,548176,67.54 %,770033,500964,65.06 %,1581665,1049140,66.33 %
,10 - Singhbhum,583444,403528,69.16 %,569126,391758,68.84 %,1152570,795286,69.00 %
,11 - Khunti,565544,373120,65.98 %,546308,363835,66.60 %,1111852,736955,66.28 %
,12 - Lohardaga,578883,333938,57.69 %,540261,317522,58.77 %,1119144,651460,58.21 %
,13 - Palamau,890010,523454,58.81 %,755947,453869,60.04 %,1645957,977323,59.38 %
,14 - Hazaribagh,812487,515008,63.39 %,706344,452144,64.01 %,1518831,967152,63.68 %
,State Total: ,10685149,6860476,64.21 %,9641594,6122464,63.5 %,20326743,12982940,63.87 %
Karnataka,1 - Chikkodi,746113,564257,75.63 %,696183,506846,72.80 %,1442296,1071103,74.26 %
,2 - Belgaum,807598,570120,70.59 %,773419,508427,65.74 %,1581017,1078547,68.22 %
,3 - Bagalkot,793338,561781,70.81 %,775282,517529,66.75 %,1568620,1079310,68.81 %
,4 - Bijapur,847815,521565,61.52 %,774820,445192,57.46 %,1622635,966757,59.58 %
,5 - Gulbarga,878311,523062,59.55 %,843679,474576,56.25 %,1721990,997638,57.94 %
,6 - Raichur,835969,508764,60.86 %,825637,460125,55.73 %,1661606,968889,58.31 %
,7 - Bidar,839154,506363,60.34 %,761808,453021,59.47 %,1600962,959384,59.93 %
,8 - Koppal,770316,526001,68.28 %,764789,480507,62.83 %,1535105,1006508,65.57 %
,9 - Bellary,750789,542128,72.21 %,737156,503644,68.32 %,1487945,1045772,70.28 %
,10 - Haveri,807076,595257,73.75 %,751673,520711,69.27 %,1558749,1115968,71.59 %
,11 - Dharwad,809486,562991,69.55 %,769538,478235,62.15 %,1579024,1041226,65.94 %
,12 - Uttara Kannada,742865,521541,70.21 %,707734,479497,67.75 %,1450599,1001038,69.01 %
,13 - Davanagere,772126,581292,75.28 %,750586,533576,71.09 %,1522712,1114868,73.22 %
,14 - Shimoga,778767,572407,73.50 %,783474,556601,71.04 %,1562241,1129008,72.27 %
,15 - Udupi Chikmagalur,679286,511470,75.30 %,708009,522638,73.82 %,1387295,1034108,74.54 %
,16 - Hassan,789668,586090,74.22 %,771668,561082,72.71 %,1561336,1147172,73.47 %
,17 - Dakshina Kannada,774500,595647,76.91 %,790781,611827,77.37 %,1565281,1207474,77.14 %
,18 - Chitradurga,844864,573250,67.85 %,816408,523249,64.09 %,1661272,1096499,66.00 %
,19 - Tumkur,764561,565612,73.98 %,753957,535872,71.07 %,1518518,1101484,72.54 %
,20 - Mandya,839052,604906,72.09 %,830210,587732,70.79 %,1669262,1192638,71.45 %
,21 - Mysore,867893,598003,68.90 %,855241,561591,65.66 %,1723134,1159594,67.30 %
,22 - Chamarajanagar,789383,585209,74.13 %,766396,547820,71.48 %,1555779,1133029,72.83 %
,23 - Bangalore Rural,1135845,758619,66.79 %,1054552,696625,66.06 %,2190397,1455244,66.44 %
,24 - Bangalore North,1260356,721638,57.26 %,1141116,635080,55.65 %,2401472,1356718,56.50 %
,25 - Bangalore central,1010586,574475,56.85 %,921077,500114,54.30 %,1931663,1074589,55.63 %
,26 - Bangalore South,1051316,597291,56.81 %,948566,516435,54.44 %,1999882,1113726,55.69 %
,27 - Chikkballapur,843740,653492,77.45 %,814602,609782,74.86 %,1658342,1263274,76.18 %
,28 - Kolar,755450,582601,77.12 %,737525,544722,73.86 %,1492975,1127323,75.51 %
,State Total: ,23586223,16165832,68.54 %,22625886,14873056,65.73 %,46212109,31038888,67.17 %
Kerala,1 - Kasaragod,595047,459537,77.23 %,648683,514678,79.34 %,1243730,974215,78.33 %
,2 - Kannur,548454,439557,80.14 %,621812,507560,81.63 %,1170266,947117,80.93 %
,3 - Vadakara,561168,437556,77.97 %,621336,521786,83.98 %,1182504,959342,81.13 %
,4 - Wayanad,614822,454300,73.89 %,634598,460706,72.60 %,1249420,915006,73.23 %
,5 - Kozhikode,571709,457548,80.03 %,610775,485461,79.48 %,1182484,943009,79.75 %
,6 - Malappuram,598207,415980,69.54 %,600237,437487,72.89 %,1198444,853467,71.21 %
,7 - Ponnani,574106,405116,70.56 %,606683,466476,76.89 %,1180789,871592,73.81 %
,8 - Palakkad,587379,444510,75.68 %,621379,465812,74.96 %,1208758,910322,75.31 %
,9 - Alathur ,591950,452858,76.50 %,624401,474370,75.97 %,1216351,927228,76.23 %
,10 - Thrissur,606518,434202,71.59 %,668770,486303,72.72 %,1275288,920505,72.18 %
,11 - Chalakudy,565081,436712,77.28 %,585410,447321,76.41 %,1150491,884033,76.84 %
,12 - Ernakulam,565809,428565,75.74 %,590658,422269,71.49 %,1156467,850834,73.57 %
,13 - Idukki,578849,425049,73.43 %,579886,394717,68.07 %,1158735,819766,70.75 %
,14 - Kottayam,573571,426879,74.42 %,587892,404757,68.85 %,1161463,831636,71.60 %
,15 - Alappuzha,611877,477885,78.10 %,659447,519579,78.79 %,1271324,997464,78.46 %
,16 - Mavelikkara ,592702,416969,70.35 %,659966,472091,71.53 %,1252668,889060,70.97 %
,17 - Pathanamthitta,631495,425771,67.42 %,692411,443681,64.08 %,1323906,869452,65.67 %
,18 - Kollam,575296,408322,70.98 %,644119,470734,73.08 %,1219415,879056,72.09 %
,19 - Attingal,575780,396246,68.82 %,675618,463104,68.55 %,1251398,859350,68.67 %
,20 - Thiruvananthapuram,614438,434623,70.74 %,658310,438816,66.66 %,1272748,873439,68.63 %
,State Total: ,11734258,8678185,73.96 %,12592391,9297708,73.84 %,24326649,17975893,73.89 %
Lakshadweep,1 - Lakshadweep,25433,21585,84.87 %,24489,21654,88.42 %,49922,43239,86.61 %
,State Total: ,25433,21585,84.87 %,24489,21654,88.42 %,49922,43239,86.61 %
Madhya Pradesh,1 - MORENA,938466,538708,57.40 %,764026,315571,41.30 %,1702492,854279,50.18 %
,2 - BHIND,890851,469603,52.71 %,707318,259481,36.69 %,1598169,729084,45.62 %
,3 - GWALIOR,1024155,595934,58.19 %,852848,394978,46.31 %,1877003,990912,52.79 %
,4 - GUNA,857328,581485,67.83 %,748291,395144,52.81 %,1605619,976629,60.83 %
,5 - SAGAR,815357,536674,65.82 %,704827,355255,50.40 %,1520184,891929,58.67 %
,6 - TIKAMGARH,820908,466689,56.85 %,708095,299632,42.32 %,1529003,766321,50.12 %
,7 - DAMOH,882506,557919,63.22 %,768600,354161,46.08 %,1651106,912080,55.24 %
,8 - KHAJURAHO,907312,517341,57.02 %,795482,357136,44.90 %,1702794,874477,51.36 %
,9 - SATNA,772026,499928,64.76 %,686058,413516,60.27 %,1458084,913444,62.65 %
,10 - REWA,821800,457663,55.69 %,722919,372339,51.50 %,1544719,830002,53.73 %
,11 - SIDHI,915700,548026,59.85 %,820350,441370,53.80 %,1736050,989396,56.99 %
,12 - SHAHDOL,806945,527939,65.42 %,754376,440579,58.40 %,1561321,968518,62.03 %
,13 - JABALPUR,897949,558617,62.21 %,813734,443567,54.51 %,1711683,1002184,58.55 %
,14 - MANDLA,925971,641915,69.32 %,898453,576603,64.18 %,1824424,1218518,66.79 %
,15 - BALAGHAT,822667,571601,69.48 %,807102,541763,67.12 %,1629769,1113364,68.31 %
,16 - CHHINDWARA,721482,584759,81.05 %,679795,522739,76.90 %,1401277,1107498,79.03 %
,17 - HOSHANGABAD,835492,593957,71.09 %,732635,437218,59.68 %,1568127,1031175,65.76 %
,18 - VIDISHA,872410,621326,71.22 %,761960,452147,59.34 %,1634370,1073473,65.68 %
,19 - BHOPAL,1039004,639683,61.57 %,917932,490499,53.44 %,1956936,1130182,57.75 %
,20 - RAJGARH,827001,598652,72.39 %,751747,412072,54.82 %,1578748,1010724,64.02 %
,21 - DEWAS,843555,654121,77.54 %,773660,489847,63.32 %,1617215,1143968,70.74 %
,22 - UJJAIN,790889,571525,72.26 %,734592,444880,60.56 %,1525481,1016405,66.63 %
,23 - MANDSOUR,838076,640484,76.42 %,788495,520865,66.06 %,1626571,1161349,71.40 %
,24 - RATLAM,860947,570248,66.23 %,841701,512433,60.88 %,1702648,1082681,63.59 %
,25 - DHAR,858093,586865,68.39 %,810348,489951,60.46 %,1668441,1076816,64.54 %
,26 - INDORE,1106461,736759,66.59 %,1008842,580058,57.50 %,2115303,1316817,62.25 %
,27 - KHARGONE,866897,614411,70.87 %,836374,538114,64.34 %,1703271,1152525,67.67 %
,28 - KHANDWA,912747,677574,74.23 %,846663,579753,68.48 %,1759410,1257327,71.46 %
,29 - BETUL,836835,574150,68.61 %,770987,473569,61.42 %,1607822,1047719,65.16 %
,State Total: ,25309830,16734556,66.12 %,22808210,12905240,56.58 %,48118040,29639796,61.6 %
Maharashtra,1 - Nandurbar ,852379,584580,68.58 %,820336,532096,64.86 %,1672715,1116676,66.76 %
,2 - Dhule,878610,543252,61.83 %,795859,439831,55.26 %,1674469,983083,58.71 %
,3 - Jalgaon,909027,594892,65.44 %,798906,395440,49.50 %,1707933,990332,57.98 %
,4 - Raver,842682,554159,65.76 %,750688,455054,60.62 %,1593370,1009213,63.34 %
,5 - Buldhana,845547,535993,63.39 %,750687,442633,58.96 %,1596234,978626,61.31 %
,6 - Akola,869922,544432,62.58 %,776541,434059,55.90 %,1646463,978491,59.43 %
,7 - Amravati ,848050,556250,65.59 %,763315,447811,58.67 %,1611365,1004061,62.31 %
,8 - Wardha,817514,554658,67.85 %,747039,458787,61.41 %,1564553,1013445,64.78 %
,9 - Ramtek ,887157,576939,65.03 %,790088,473377,59.91 %,1677245,1050316,62.62 %
,10 - Nagpur ,979995,579529,59.14 %,920792,505529,54.90 %,1900787,1085058,57.08 %
,11 - Bhandara - gondiya,841442,615957,73.20 %,814842,581239,71.33 %,1656284,1197196,72.28 %
,12 - Gadchiroli-Chimur,753927,537086,71.24 %,715840,490043,68.46 %,1469767,1027129,69.88 %
,13 - Chandrapur,921099,602923,65.46 %,832591,506820,60.87 %,1753690,1109743,63.28 %
,14 - Yavatmal-Washim,916049,585785,63.95 %,827449,447164,54.04 %,1743498,1032949,59.25 %
,15 - Hingoli ,839540,576774,68.70 %,746654,474390,63.54 %,1586194,1051164,66.27 %
,16 - Nanded,878553,549945,62.60 %,808504,463405,57.32 %,1687057,1013350,60.07 %
,17 - Parbhani,945899,637950,67.44 %,857893,524283,61.11 %,1803792,1162233,64.43 %
,18 - Jalna,866726,596359,68.81 %,745328,469900,63.05 %,1612054,1066259,66.14 %
,19 - Aurangabad,846023,554669,65.56 %,743370,428264,57.61 %,1589393,982933,61.84 %
,20 - Dindori ,808018,546989,67.70 %,722121,423193,58.60 %,1530139,970182,63.40 %
,21 - Nashik,850457,524572,61.68 %,742780,412833,55.58 %,1593237,937405,58.84 %
,22 - Palghar ,830432,532639,64.14 %,747645,459979,61.52 %,1578077,992618,62.90 %
,23 - Bhiwandi,945405,503035,53.21 %,751184,372570,49.60 %,1696589,875605,51.61 %
,24 - Kalyan,1045495,470781,45.03 %,876551,353415,40.32 %,1922046,824196,42.88 %
,25 - Thane,1142158,591189,51.76 %,931284,463000,49.72 %,2073442,1054189,50.84 %
,26 - Mumbai North,972645,527803,54.26 %,811225,418759,51.62 %,1783870,946562,53.06 %
,27 - Mumbai North West,986908,503191,50.99 %,788520,392326,49.75 %,1775428,895517,50.44 %
,28 - Mumbai North East,923016,485775,52.63 %,745341,375986,50.44 %,1668357,861761,51.65 %
,29 - Mumbai North central,967474,472265,48.81 %,771420,373027,48.36 %,1738894,845292,48.61 %
,30 - Mumbai South central,793801,424521,53.48 %,654084,344539,52.68 %,1447885,769060,53.12 %
,31 - Mumbai   South,828964,437435,52.77 %,656882,343280,52.26 %,1485846,780715,52.54 %
,32 - Raigad,752491,485586,64.53 %,780290,502180,64.36 %,1532781,987766,64.44 %
,33 - Maval,1035960,647176,62.47 %,917781,527159,57.44 %,1953741,1174335,60.11 %
,34 - Pune,949567,533686,56.20 %,886269,459588,51.86 %,1835836,993274,54.10 %
,35 - Baramati,960387,602604,62.75 %,853156,463952,54.38 %,1813543,1066556,58.81 %
,36 - Shirur,973236,613828,63.07 %,850876,475678,55.90 %,1824112,1089506,59.73 %
,37 - Ahmadnagar ,898819,595960,66.30 %,800589,466358,58.25 %,1699408,1062318,62.51 %
,38 - Shirdi,765921,520229,67.92 %,693791,412416,59.44 %,1459712,932645,63.89 %
,39 - Beed,963462,681038,70.69 %,829188,551164,66.47 %,1792650,1232202,68.74 %
,40 - Osmanabad,932838,612411,65.65 %,793955,505740,63.70 %,1726793,1118151,64.75 %
,41 - Latur ,897919,578053,64.38 %,784688,479103,61.06 %,1682607,1057156,62.83 %
,42 - Solapur ,893736,527346,59.00 %,809019,423855,52.39 %,1702755,951201,55.86 %
,43 - Madha,912736,595626,65.26 %,814572,483993,59.42 %,1727308,1079619,62.50 %
,44 - Sangli,861582,558707,64.85 %,787525,487952,61.96 %,1649107,1046659,63.47 %
,45 - Satara,884020,519692,58.79 %,835978,456989,54.67 %,1719998,976681,56.78 %
,46 - Ratnagiri - sindhudurg,665668,444364,66.75 %,701693,451892,64.40 %,1367361,896256,65.55 %
,47 - Kolhapur,909326,664298,73.05 %,848974,595991,70.20 %,1758300,1260289,71.68 %
,48 - Hatkanangle,850574,631647,74.26 %,780024,557224,71.44 %,1630598,1188871,72.91 %
,State Total: ,42743156,26714578,62.5 %,37974127,22004266,57.95 %,80717283,48718844,60.36 %
Manipur,1 - Inner manipur,417122,306721,73.53 %,438237,334150,76.25 %,855359,640871,74.92 %
,2 - Outer manipur,454309,378706,83.36 %,464657,393060,84.59 %,918966,771766,83.98 %
,State Total: ,871431,685427,78.66 %,902894,727210,80.54 %,1774325,1412637,79.62 %
Meghalaya,1 - Shillong,480409,292944,60.98 %,500331,327043,65.37 %,980740,619987,63.22 %
,2 - Tura ,297230,231830,78.00 %,289271,226241,78.21 %,586501,458071,78.10 %
,State Total: ,777639,524774,67.48 %,789602,553284,70.07 %,1567241,1078058,68.79 %
Mizoram,1 - MIZORAM,346219,216167,62.44 %,355951,217034,60.97 %,702170,433201,61.69 %
,State Total: ,346219,216167,62.44 %,355951,217034,60.97 %,702170,433201,61.69 %
Nagaland,1 - Nagaland,600490,529325,88.15 %,582458,509585,87.49 %,1182948,1038910,87.82 %
,State Total: ,600490,529325,88.15 %,582458,509585,87.49 %,1182948,1038910,87.82 %
NCT OF Delhi,1 - CHANDNI CHOWK                 ,791317,550825,69.61 %,655911,431038,65.72 %,1447228,981863,67.84 %
,2 - NORTH EAST DELHI              ,1079406,741003,68.65 %,878301,576335,65.62 %,1957707,1317338,67.29 %
,3 - EAST DELHI                    ,1023325,676648,66.12 %,806253,519688,64.46 %,1829578,1196336,65.39 %
,4 - NEW DELHI                     ,830322,546295,65.79 %,659825,423517,64.19 %,1490147,969812,65.08 %
,5 - NORTH WEST DELHI              ,1212553,756939,62.43 %,981872,599097,61.02 %,2194425,1356036,61.79 %
,6 - WEST DELHI                    ,1108886,743406,67.04 %,930524,604565,64.97 %,2039410,1347971,66.10 %
,7 - SOUTH DELHI                   ,1005289,638406,63.50 %,747452,464004,62.08 %,1752741,1102410,62.90 %
,State Total: ,7051098,4653522,66 %,5660138,3618244,63.93 %,12711236,8271766,65.07 %
Orissa,1 - Bargarh,751140,595911,79.33 %,679577,527390,77.61 %,1430717,1123301,78.51 %
,2 - Sundargarh ,718689,515665,71.75 %,691843,495046,71.55 %,1410532,1010711,71.65 %
,3 - Sambalpur,669036,505640,75.58 %,628062,478669,76.21 %,1297098,984309,75.89 %
,4 - Keonjhar ,691369,550822,79.67 %,655314,533047,81.34 %,1346683,1083869,80.48 %
,5 - Mayurbhanj ,670100,523329,78.10 %,657455,530070,80.62 %,1327555,1053399,79.35 %
,6 - Balasore,709342,531966,74.99 %,656876,517484,78.78 %,1366218,1049450,76.81 %
,7 - Bhadrak ,774566,537966,69.45 %,694932,543373,78.19 %,1469498,1081339,73.59 %
,8 - Jajpur ,696385,511297,73.42 %,607348,469138,77.24 %,1303733,980435,75.20 %
,9 - Dhenkanal,722328,551897,76.41 %,641139,490204,76.46 %,1363467,1042101,76.43 %
,10 - Bolangir,814968,605802,74.33 %,748057,564603,75.48 %,1563025,1170405,74.88 %
,11 - Kalahandi,750694,568938,75.79 %,723441,548598,75.83 %,1474135,1117536,75.81 %
,12 - Nabarangpur ,645875,512721,79.38 %,651335,509451,78.22 %,1297210,1022172,78.80 %
,13 - Kandhamal,582340,417777,71.74 %,561262,421638,75.12 %,1143602,839415,73.40 %
,14 - Cuttack,731918,522770,71.42 %,639699,455834,71.26 %,1371617,978604,71.35 %
,15 - Kendrapara ,828491,580768,70.10 %,726953,560231,77.07 %,1555444,1140999,73.36 %
,16 - Jagatsinghpur ,797923,588605,73.77 %,701750,543327,77.42 %,1499673,1131932,75.48 %
,17 - Puri,742939,540898,72.81 %,661642,498491,75.34 %,1404581,1039389,74.00 %
,18 - Bhubaneswar,835850,483992,57.90 %,691918,407830,58.94 %,1527768,891822,58.37 %
,19 - Aska,750999,449485,59.85 %,657781,446796,67.92 %,1408780,896281,63.62 %
,20 - Berhampur,680089,451051,66.32 %,654179,454311,69.45 %,1334268,905362,67.85 %
,21 - Koraput ,629268,485223,77.11 %,671169,504221,75.13 %,1300437,989444,76.09 %
,State Total: ,15194309,11032523,72.61 %,14001732,10499752,74.99 %,29196041,21532275,73.75 %
Puducherry,1 - Puducherry,432048,351360,81.32 %,469309,388657,82.81 %,901357,740017,82.10 %
,State Total: ,432048,351360,81.32 %,469309,388657,82.81 %,901357,740017,82.1 %
Punjab,1 - Gurdaspur,784477,532819,67.92 %,715860,509880,71.23 %,1500337,1042699,69.50 %
,2 - Amritsar,779164,537641,69.00 %,698098,469555,67.26 %,1477262,1007196,68.18 %
,3 - Khadoor Sahib,817062,536595,65.67 %,746194,503923,67.53 %,1563256,1040518,66.56 %
,4 - Jalandhar,808530,532246,65.83 %,742967,508516,68.44 %,1551497,1040762,67.08 %
,5 - Hoshiarpur,762065,473343,62.11 %,723221,487954,67.47 %,1485286,961297,64.72 %
,6 - Anandpur Sahib,817186,554256,67.82 %,747535,532307,71.21 %,1564721,1086563,69.44 %
,7 - Ludhiana,835632,600960,71.92 %,725569,499497,68.84 %,1561201,1100457,70.49 %
,8 - Fatehgarh Sahib,740390,551251,74.45 %,656567,479703,73.06 %,1396957,1030954,73.80 %
,9 - Faridkot,768206,548771,71.44 %,686869,483336,70.37 %,1455075,1032107,70.93 %
,10 - Firozpur,808857,590511,73.01 %,713254,514901,72.19 %,1522111,1105412,72.62 %
,11 - Bathinda,813119,627099,77.12 %,712170,549668,77.18 %,1525289,1176767,77.15 %
,12 - Sangrur,758197,583487,76.96 %,666546,515980,77.41 %,1424743,1099467,77.17 %
,13 - Patiala,834231,593646,71.16 %,746042,527287,70.68 %,1580273,1120933,70.93 %
,State Total: ,10327116,7262625,70.33 %,9280892,6582507,70.93 %,19608008,13845132,70.61 %
Rajasthan,1 - Ganganagar,909749,681063,74.86 %,808672,575743,71.20 %,1718421,1256806,73.14 %
,2 - Bikaner,847064,526983,62.21 %,744004,402768,54.14 %,1591068,929751,58.44 %
,3 - Churu,928040,600164,64.67 %,825785,530940,64.30 %,1753825,1131104,64.49 %
,4 - Jhunjhunu,893354,524368,58.70 %,803434,482097,60.00 %,1696788,1006465,59.32 %
,5 - Sikar,944231,555682,58.85 %,826193,510068,61.74 %,1770424,1065750,60.20 %
,6 - Jaipur Rural,906275,554084,61.14 %,793187,459607,57.94 %,1699462,1013691,59.65 %
,7 - Jaipur,1047468,716874,68.44 %,910350,579932,63.70 %,1957818,1296806,66.24 %
,8 - Alwar,871339,587242,67.40 %,756728,475063,62.78 %,1628067,1062305,65.25 %
,9 - BHARATPUR,911069,548105,60.16 %,775828,414327,53.40 %,1686897,962432,57.05 %
,10 - KARAULI-DHOLPUR,845665,491661,58.14 %,703997,354280,50.32 %,1549662,845941,54.59 %
,11 - Dausa,814648,519866,63.81 %,709447,410626,57.88 %,1524095,930492,61.05 %
,12 - TONK-SAWAI MADHOPUR,910730,583685,64.09 %,800045,459355,57.42 %,1710775,1043040,60.97 %
,13 - Ajmer,869354,614697,70.71 %,813938,541617,66.54 %,1683292,1156314,68.69 %
,14 - Nagaur,886731,532331,60.03 %,791931,471688,59.56 %,1678662,1004019,59.81 %
,15 - Pali,994082,581099,58.46 %,898948,514488,57.23 %,1893030,1095587,57.87 %
,16 - Jodhpur,910466,600132,65.91 %,816897,478466,58.57 %,1727363,1078598,62.44 %
,17 - Barmer,895593,655642,73.21 %,781989,563477,72.06 %,1677582,1219119,72.67 %
,18 - Jalore,964047,581038,60.27 %,860921,506234,58.80 %,1824968,1087272,59.58 %
,19 - Udaipur,930007,601374,64.66 %,887933,591828,66.65 %,1817940,1193202,65.63 %
,20 - Banswara,863920,579152,67.04 %,828582,592036,71.45 %,1692502,1171188,69.20 %
,21 - Chittorgarh,928572,632047,68.07 %,889575,540582,60.77 %,1818147,1172629,64.50 %
,22 - Rajsamand,879526,508738,57.84 %,819875,473381,57.74 %,1699401,982119,57.79 %
,23 - Bhilwara,904030,581524,64.33 %,850847,522566,61.42 %,1754877,1104090,62.92 %
,24 - Kota,913386,634766,69.50 %,831153,520194,62.59 %,1744539,1154960,66.20 %
,25 - JHALAWAR-BARAN,868977,635659,73.15 %,800865,510705,63.77 %,1669842,1146364,68.65 %
,State Total: ,22638323,14627976,64.62 %,20331124,12482068,61.39 %,42969447,27110044,63.09 %
Sikkim,1 - Sikkim,190886,158222,82.89 %,179725,150745,83.88 %,370611,308967,83.37 %
,State Total: ,190886,158222,82.89 %,179725,150745,83.88 %,370611,308967,83.37 %
Tamil Nadu,1 - Thiruvallur ,852794,645535,75.70 %,850039,608905,71.63 %,1702833,1254440,73.67 %
,2 - Chennai North,707696,464795,65.68 %,714690,445319,62.31 %,1422386,910114,63.99 %
,3 - Chennai South,901207,552474,61.30 %,894573,528689,59.10 %,1795780,1081163,60.21 %
,4 - Chennai central,665278,422278,63.47 %,662749,392616,59.24 %,1328027,814894,61.36 %
,5 - Sriperumbudur,982862,666226,67.78 %,963641,620421,64.38 %,1946503,1286647,66.10 %
,6 - Kancheepuram ,736993,575483,78.09 %,743130,552916,74.40 %,1480123,1128399,76.24 %
,7 - Arakkonam,692883,543546,78.45 %,708662,545506,76.98 %,1401545,1089052,77.70 %
,8 - Vellore,652064,483973,74.22 %,660187,490797,74.34 %,1312251,974770,74.28 %
,9 - Krishnagiri,705468,545948,77.39 %,674489,522443,77.46 %,1379957,1068391,77.42 %
,10 - Dharmapuri,696496,567633,81.50 %,661777,533712,80.65 %,1358273,1101345,81.08 %
,11 - Tiruvannamalai,675321,529027,78.34 %,677645,538420,79.45 %,1352966,1067447,78.90 %
,12 - Arani,683921,548023,80.13 %,685747,548023,79.92 %,1369668,1096046,80.02 %
,13 - Viluppuram,694932,537023,77.28 %,692075,530618,76.67 %,1387007,1067641,76.97 %
,14 - Kallakurichi,707219,542991,76.78 %,705280,564250,80.00 %,1412499,1107241,78.39 %
,15 - Salem,759981,593783,78.13 %,738369,556513,75.37 %,1498350,1150296,76.77 %
,16 - Namakkal,661113,526519,79.64 %,668439,532236,79.62 %,1329552,1058755,79.63 %
,17 - Erode,656659,511553,77.90 %,664736,497029,74.77 %,1321395,1008582,76.33 %
,18 - Tiruppur,697730,543998,77.97 %,677859,506192,74.68 %,1375589,1050190,76.34 %
,19 - Nilgiris ,629731,473163,75.14 %,639432,459913,71.93 %,1269163,933076,73.52 %
,20 - Coimbatore,869034,608666,70.04 %,851177,567954,66.73 %,1720211,1176620,68.40 %
,21 - Pollachi,686943,514739,74.93 %,694562,497928,71.69 %,1381505,1012667,73.30 %
,22 - Dindigul,696160,538540,77.36 %,704371,544824,77.35 %,1400531,1083364,77.35 %
,23 - Karur,641693,511860,79.77 %,656629,534674,81.43 %,1298322,1046534,80.61 %
,24 - Tiruchirappalli,689228,492050,71.39 %,697912,496200,71.10 %,1387140,988250,71.24 %
,25 - Perambalur,634285,500157,78.85 %,651149,530669,81.50 %,1285434,1030826,80.19 %
,26 - Cuddalore ,625652,486263,77.72 %,622256,498275,80.08 %,1247908,984538,78.90 %
,27 - Chidambaram ,686864,531368,77.36 %,679325,557055,82.00 %,1366189,1088423,79.67 %
,28 - Mayiladuthurai,679940,503949,74.12 %,670378,521589,77.81 %,1350318,1025538,75.95 %
,29 - Nagapattinam ,606339,454047,74.88 %,604287,488155,80.78 %,1210626,942202,77.83 %
,30 - Thanjavur,662576,482240,72.78 %,677474,530018,78.23 %,1340050,1012258,75.54 %
,31 - Sivaganga,704489,475004,67.43 %,707884,552032,77.98 %,1412373,1027036,72.72 %
,32 - Madurai,717175,486336,67.81 %,724259,492010,67.93 %,1441434,978346,67.87 %
,33 - Theni ,720709,529187,73.43 %,720593,546396,75.83 %,1441302,1075583,74.63 %
,34 - Virudhunagar,669589,497074,74.24 %,680906,513856,75.47 %,1350495,1010930,74.86 %
,35 - Ramanathapuram,731467,465888,63.69 %,724424,535160,73.87 %,1455891,1001048,68.76 %
,36 - Thoothukkudi,651366,449405,68.99 %,659231,467373,70.90 %,1310597,916778,69.95 %
,37 - Tenkasi ,688958,490748,71.23 %,693123,527190,76.06 %,1382081,1017938,73.65 %
,38 - Tirunelveli,705592,469328,66.52 %,714843,493002,68.97 %,1420435,962330,67.75 %
,39 - Kanniyakumari,743378,489129,65.80 %,724418,501613,69.24 %,1467796,990742,67.50 %
,State Total: ,27571785,20249949,73.44 %,27542720,20370491,73.96 %,55114505,40620440,73.7 %
Tripura,1 - Tripura West,635976,546566,85.94 %,612574,526183,85.90 %,1248550,1072749,85.92 %
,2 - Tripura East,581599,489156,84.11 %,558670,461954,82.69 %,1140269,951110,83.41 %
,State Total: ,1217575,1035722,85.06 %,1171244,988137,84.37 %,2388819,2023859,84.72 %
Uttar Pradesh,1 - Saharanpur,873318,653286,74.81 %,735515,541022,73.56 %,1608833,1194308,74.23 %
,2 - Kairana,840623,618538,73.58 %,691132,500786,72.46 %,1531755,1119324,73.07 %
,3 - Muzaffarnagar,875186,620606,70.91 %,713297,486828,68.25 %,1588483,1107434,69.72 %
,4 - Bijnor,848606,577146,68.01 %,713459,483200,67.73 %,1562065,1060346,67.88 %
,5 - Nagina,795554,484006,60.84 %,697857,458190,65.66 %,1493411,942196,63.09 %
,6 - Moradabad,961962,627713,65.25 %,810084,500252,61.75 %,1772046,1127965,63.65 %
,7 - Rampur,872084,526970,60.43 %,744900,429419,57.65 %,1616984,956389,59.15 %
,8 - Sambhal,931603,600271,64.43 %,761642,456731,59.97 %,1693245,1057002,62.42 %
,9 - Amroha,829446,589901,71.12 %,714796,505959,70.78 %,1544242,1095860,70.96 %
,10 - Meerut,971956,632847,65.11 %,792432,480537,60.64 %,1764388,1113384,63.10 %
,11 - Baghpat,850681,582774,68.51 %,654494,421489,64.40 %,1505175,1004263,66.72 %
,12 - Ghaziabad,1333051,782170,58.68 %,1024495,560150,54.68 %,2357546,1342320,56.94 %
,13 - Gautam Buddha Nagar,1105855,690761,62.46 %,880262,508477,57.76 %,1986117,1199238,60.38 %
,14 - Bulandshahr,930831,549484,59.03 %,805616,460226,57.13 %,1736447,1009710,58.15 %
,15 - Aligarh,965995,596785,61.78 %,827131,467572,56.53 %,1793126,1064357,59.36 %
,16 - Hathras,969908,596931,61.55 %,789019,452342,57.33 %,1758927,1049273,59.65 %
,17 - Mathura,931615,619091,66.45 %,750645,457777,60.98 %,1682260,1076868,64.01 %
,18 - Agra,1003777,622009,61.97 %,810962,448391,55.29 %,1814739,1070400,58.98 %
,19 - Fatehpur Sikri,877271,565971,64.51 %,703311,401997,57.16 %,1580582,967968,61.24 %
,20 - Firozabad,902514,643433,71.29 %,734224,461173,62.81 %,1636738,1104606,67.49 %
,21 - Mainpuri,900568,580173,64.42 %,752497,419092,55.69 %,1653065,999265,60.45 %
,22 - Etah,856974,520292,60.71 %,720483,405989,56.35 %,1577457,926281,58.72 %
,23 - Badaun,978040,595491,60.89 %,791105,432103,54.62 %,1769145,1027594,58.08 %
,24 - Aonla,917060,572792,62.46 %,736517,422849,57.41 %,1653577,995641,60.21 %
,25 - Bareilly,911410,575414,63.13 %,752671,442477,58.79 %,1664081,1017891,61.17 %
,26 - Pilibhit,903420,586205,64.89 %,767731,464342,60.48 %,1671151,1050547,62.86 %
,27 - Shahjahanpur,1100020,664459,60.40 %,879274,465382,52.93 %,1979294,1129841,57.08 %
,28 - Kheri,904863,606301,67.00 %,774603,471567,60.88 %,1679466,1077868,64.18 %
,29 - Dhaurahra,846798,605309,71.48 %,711241,454962,63.97 %,1558039,1060271,68.05 %
,30 - Sitapur,837981,582088,69.46 %,712282,444884,62.46 %,1550263,1026972,66.25 %
,31 - Hardoi,939831,565543,60.17 %,774556,407351,52.59 %,1714387,972894,56.75 %
,32 - Misrikh,948290,590503,62.27 %,777295,407811,52.47 %,1725585,998314,57.85 %
,33 - Unnao,1194396,674580,56.48 %,969996,527023,54.33 %,2164392,1201603,55.52 %
,34 - Mohanlalganj,995313,638688,64.17 %,842881,477900,56.70 %,1838194,1116588,60.74 %
,35 - Lucknow,1052171,582227,55.34 %,897785,451556,50.30 %,1949956,1033783,53.02 %
,36 - Rae Bareli,857875,437735,51.03 %,737079,387401,52.56 %,1594954,825136,51.73 %
,37 - Amethi,890595,461365,51.80 %,779248,413260,53.03 %,1669843,874625,52.38 %
,38 - Sultanpur,910349,499378,54.86 %,793349,465603,58.69 %,1703698,964981,56.64 %
,39 - Pratapgarh,923668,457693,49.55 %,792957,436763,55.08 %,1716625,894456,52.11 %
,40 - Farrukhabad,891934,560566,62.85 %,721847,410111,56.81 %,1613781,970677,60.15 %
,41 - Etawah,938271,530688,56.56 %,768966,408916,53.18 %,1707237,939604,55.04 %
,42 - Kannauj,1000007,629781,62.98 %,808882,484679,59.92 %,1808889,1114460,61.61 %
,43 - Kanpur,889345,485765,54.62 %,721903,349314,48.39 %,1611248,835079,51.83 %
,44 - Akbarpur,977662,559901,57.27 %,790961,411474,52.02 %,1768623,971375,54.92 %
,45 - Jalaun,1045684,579206,55.39 %,857648,529960,61.79 %,1903332,1109166,58.27 %
,46 - Jhansi,1034085,734103,70.99 %,897930,586701,65.34 %,1932015,1320804,68.36 %
,47 - Hamirpur,949328,548768,57.81 %,788665,426472,54.08 %,1737993,975240,56.11 %
,48 - Banda,884813,474053,53.58 %,717104,384273,53.59 %,1601917,858326,53.58 %
,49 - Fatehpur,985922,575050,58.33 %,818855,481638,58.82 %,1804777,1056688,58.55 %
,50 - Kaushambi,955324,491057,51.40 %,783670,418981,53.46 %,1738994,910038,52.33 %
,51 - Phulpur,1063897,541728,50.92 %,849377,418613,49.28 %,1913274,960341,50.19 %
,52 - Allahabad,917403,507043,55.27 %,749166,384539,51.33 %,1666569,891582,53.50 %
,53 - Barabanki,925946,611206,66.01 %,795336,456962,57.46 %,1721282,1068168,62.06 %
,54 - Faizabad,936036,558096,59.62 %,802665,464620,57.88 %,1738701,1022716,58.82 %
,55 - Ambedkar Nagar,923553,541200,58.60 %,795221,493204,62.02 %,1718774,1034404,60.18 %
,56 - Bahraich,882776,522627,59.20 %,755869,411636,54.46 %,1638645,934263,57.01 %
,57 - Kaiserganj,928269,527337,56.81 %,783698,416020,53.08 %,1711967,943357,55.10 %
,58 - Shrawasti,976415,559177,57.27 %,811665,420461,51.80 %,1788080,979638,54.79 %
,59 - Gonda,935168,488241,52.21 %,775659,385491,49.70 %,1710827,873732,51.07 %
,60 - Domariyaganj,961957,490141,50.95 %,799458,444886,55.65 %,1761415,935027,53.08 %
,61 - Basti,1022508,549746,53.76 %,825105,498788,60.45 %,1847613,1048534,56.75 %
,62 - Sant Kabir Nagar,1045430,520999,49.84 %,858897,490650,57.13 %,1904327,1011649,53.12 %
,63 - Maharajganj,946234,547576,57.87 %,796897,508502,63.81 %,1743131,1056078,60.59 %
,64 - Gorakhpur,1055476,569717,53.98 %,849022,470482,55.41 %,1904498,1040199,54.62 %
,65 - Kushi Nagar,930637,505827,54.35 %,750355,444618,59.25 %,1680992,950445,56.54 %
,66 - Deoria,997314,508610,51.00 %,809612,462947,57.18 %,1806926,971557,53.77 %
,67 - Bansgaon,979644,459744,46.93 %,780466,418133,53.57 %,1760110,877877,49.88 %
,68 - Lalganj,906751,456696,50.37 %,754732,441959,58.56 %,1661483,898655,54.09 %
,69 - Azamgarh,941548,504787,53.61 %,761674,455431,59.79 %,1703222,960218,56.38 %
,70 - Ghosi,1040034,547483,52.64 %,851079,492173,57.83 %,1891113,1039656,54.98 %
,71 - Salempur,904632,450367,49.78 %,757105,404382,53.41 %,1661737,854749,51.44 %
,72 - Ballia,973384,573053,58.87 %,794887,369158,46.44 %,1768271,942211,53.28 %
,73 - Jaunpur,1002938,527542,52.60 %,845904,479601,56.70 %,1848842,1007143,54.47 %
,74 - Machhlishahr,1026789,513121,49.97 %,865180,484781,56.03 %,1891969,997902,52.74 %
,75 - Ghazipur,983352,529153,53.81 %,818167,457520,55.92 %,1801519,986673,54.77 %
,76 - Chandauli,927629,546179,58.88 %,741511,434393,58.58 %,1669140,980572,58.75 %
,77 - Varanasi,986224,594293,60.26 %,781262,436392,55.86 %,1767486,1030685,58.31 %
,78 - Bhadohi,1016000,527290,51.90 %,818598,454262,55.49 %,1834598,981552,53.50 %
,79 - Mirzapur,938504,557621,59.42 %,782157,450006,57.53 %,1720661,1007627,58.56 %
,80 - Robertsganj,901163,497152,55.17 %,738398,388721,52.64 %,1639561,885873,54.03 %
,State Total: ,76071444,44979619,59.13 %,62894376,36112683,57.42 %,138965820,81092302,58.35 %
Uttarakhand,1 - Tehri Garhwal,712039,403088,56.61 %,640806,373126,58.23 %,1352845,776214,57.38 %
,2 - Garhwal,652891,323143,49.49 %,616192,358881,58.24 %,1269083,682024,53.74 %
,3 - Almora,640059,312965,48.90 %,614269,343560,55.93 %,1254328,656525,52.34 %
,4 - Nainital-udhamsingh Nagar,857781,590700,68.86 %,753029,510735,67.82 %,1610810,1101435,68.38 %
,5 - Hardwar,888328,638871,71.92 %,754545,536821,71.14 %,1642873,1175692,71.56 %
,State Total: ,3751098,2268767,60.48 %,3378841,2123123,62.84 %,7129939,4391890,61.6 %
West Bengal,1 - Cooch behar,848649,688855,81.17 %,764768,643554,84.15 %,1613417,1332409,82.58 %
,2 - Alipurduars,755765,619981,82.03 %,715146,603585,84.40 %,1470911,1223566,83.18 %
,3 - Jalpaiguri,795704,676450,85.01 %,735765,625667,85.04 %,1531469,1302117,85.02 %
,4 - Darjeeling,737184,587678,79.72 %,699942,554331,79.20 %,1437126,1142009,79.46 %
,5 - Raiganj,724014,564181,77.92 %,663512,544012,81.99 %,1387526,1108193,79.87 %
,6 - Balurghat,653848,549173,83.99 %,600649,513880,85.55 %,1254497,1063053,84.74 %
,7 - Maldaha Uttar,740749,579515,78.23 %,684679,583470,85.22 %,1425428,1162985,81.59 %
,8 - Maldaha Dakshin,692386,546640,78.95 %,654757,545767,83.35 %,1347143,1092407,81.09 %
,9 - Jangipur,714890,559542,78.27 %,676766,559542,82.68 %,1391656,1119084,80.41 %
,10 - Baharampur,752943,579487,76.96 %,700840,575100,82.06 %,1453783,1154587,79.42 %
,11 - Murshidabad,782286,652896,83.46 %,729812,634867,86.99 %,1512098,1287763,85.16 %
,12 - Krishnanagar,769981,639431,83.05 %,706802,608483,86.09 %,1476783,1247914,84.50 %
,13 - Ranaghat,831318,693242,83.39 %,771531,659954,85.54 %,1602849,1353196,84.42 %
,14 - Bangaon,796650,661484,83.03 %,744063,622204,83.62 %,1540713,1283688,83.32 %
,15 - Barrackpore,682366,567820,83.21 %,604856,483310,79.90 %,1287222,1051130,81.66 %
,16 - Dum dum,715569,591353,82.64 %,690412,541291,78.40 %,1405981,1132644,80.56 %
,17 - Barasat,774305,665637,85.97 %,738487,603694,81.75 %,1512792,1269331,83.91 %
,18 - Basirhat,777768,677519,87.11 %,712828,596252,83.65 %,1490596,1273771,85.45 %
,19 - Joynagar,757902,631335,83.30 %,700822,554717,79.15 %,1458724,1186052,81.31 %
,20 - Mathurapur,772279,659848,85.44 %,716505,605683,84.53 %,1488784,1265531,85.00 %
,21 - Diamond harbour,816259,683496,83.74 %,739655,577800,78.12 %,1555914,1261296,81.06 %
,22 - Jadavpur,811441,666972,82.20 %,784305,605390,77.19 %,1595746,1272362,79.73 %
,23 - Kolkata Dakshin,890251,627205,70.45 %,795045,540774,68.02 %,1685296,1167979,69.30 %
,24 - Kolkata Uttar,797437,535236,67.12 %,636548,420542,66.07 %,1433985,955778,66.65 %
,25 - Howrah,802653,621783,77.47 %,702446,503616,71.69 %,1505099,1125399,74.77 %
,26 - Uluberia,761951,628832,82.53 %,686681,557195,81.14 %,1448632,1186027,81.87 %
,27 - Srerampur,847931,681607,80.38 %,776107,608826,78.45 %,1624038,1290433,79.46 %
,28 - Hooghly,836584,697366,83.36 %,793458,651504,82.11 %,1630042,1348870,82.75 %
,29 - Arambagh,833629,707525,84.87 %,766664,654409,85.36 %,1600293,1361934,85.11 %
,30 - Tamluk,796779,685563,86.04 %,730494,652121,89.27 %,1527273,1337684,87.59 %
,31 - Kanthi,777345,664251,85.45 %,713064,626560,87.87 %,1490409,1290811,86.61 %
,32 - Ghatal,835803,691145,82.69 %,774686,675564,87.20 %,1610489,1366709,84.86 %
,33 - Jhargram,753840,646539,85.77 %,721272,611074,84.72 %,1475112,1257613,85.26 %
,34 - Medinipur,770363,647026,83.99 %,729310,613006,84.05 %,1499673,1260032,84.02 %
,35 - Purulia,764758,627033,81.99 %,707175,577642,81.68 %,1471933,1204675,81.84 %
,36 - Bankura,775893,645606,83.21 %,727919,590713,81.15 %,1503812,1236319,82.21 %
,37 - Bishnupur,759317,667837,87.95 %,707604,604233,85.39 %,1466921,1272070,86.72 %
,38 - Bardhaman Purba,795545,683049,85.86 %,736699,637873,86.59 %,1532244,1320922,86.21 %
,39 - Burdwan - durgapur,821377,700899,85.33 %,762121,630343,82.71 %,1583498,1331242,84.07 %
,40 - Asansol,791896,633230,79.96 %,677788,509165,75.12 %,1469684,1142395,77.73 %
,41 - Bolpur,798384,681996,85.42 %,740045,622760,84.15 %,1538429,1304756,84.81 %
,42 - Birbhum,773457,670443,86.68 %,721651,605376,83.89 %,1495108,1275819,85.33 %
,State Total: ,32689449,26886706,82.25 %,30143679,24735849,82.06 %,62833128,51622555,82.16 %
India: ,,437051538,293236779,67.09 %,397049941,260565022,65.63 %,834101479,553801801,66.4 %
